11111111111111111
1010C000100C010C1
10000010100C01011
100101E0C0P000011
11111111111111111