11111111111111111
1C1000C0100001EC1
100C0000100000001
1C0101P0000111011
11111111111111111