11111111111111111
10000000000001EC1
10000000000010P01
11111111111111111