11111111111111111
10100000100001001
10000000100C00001
1001E000C0P111011
11111111111111111