11111111111111111
1010C000100C010C1
10000010100C00001
100101E0C0P111011
11111111111111111